1111111111
1P00EC0C01
10C00C1001
1110011111
1000000001
11C01110C1
100C000001
1101111011
1C0000C001
1111111111
