1111111111
1P00CCXCE1
1110000001
1E00000001
1111111111