1111111111
1P00E00001
1000001001
1110X11111
1C00000001
1111101111
100000X001
1111111111
